#
# 0 E room10.txt 1
# 1 E room12.txt 0
#
WWWWWWWWWW
WRRTR RRRW
WRR RRR RW
WWWWR RWRW
0RRWR TWRW
WRRWRR WR1
WRRW RRWWW
WRRW RRTRW
WRRRR  RRW
WWWWWWWWWW