#
# 0 D room7.txt 1
#
WWWWWWWWWW
W        W
W        W
W        W
0    f   W
W        W
W        W
W        W
W        W
WWWWWWWWWW