#
# 0 D room1.txt 1 key1
# 1 D room1.txt 0
# 2 D room3.txt 0 key2
#
# k key1
#
WWW2WWWWWW
WS   G  RW
W        W
W  m  k  W
W        W
W      W W
W    BRWhW
W  RWWWW W
0R RW   RW
WWWWW1WWWW