#
# 0 D room5.txt 1
# 1 D room7.txt 0
#
WWWW1WWWWW
Wttt ttttW
Wtt    ttW
Wt  G   tW
Wtt  G ttW
Wt      tW
Wt t  tmtW
W       tW
0  ttttttW
WWWWWWWWWW