#
# 0 E room8.txt 2
# 1 E room11.txt 0
#
WWWWWWWWWW
WmRRRBRRRW
WRRRBRRRBW
WWWWWRRWWW
0RRRRRRRR1
WWWWWWRRWW
WBRRBRRRRW
WRRRRBRRBW
WmRRRRBRRW
WWWWWWWWWW