#
# 0 D room7.txt 1
# 1 Y room9.txt 0
#
AAAA1AAAAA
W        W
W        W
W        W
0        W
W        W
W        W
W        W
W        W
WWWWWWWWWW