#
# 0 D room3.txt 1
# 1 D room5.txt 0
#
WWWW1WWWWW
WSWW WSWSW
WWWW WWWWW
WSWW WSWSW
WWWWmWWWWW
WSWWCWSWSW
WWWW WWWWW
WSWW WSWSW
WWWW WWWWW
WWWW0WWWWW