#
# 0 D room2.txt 2 key2
#
WWWWWWWWWW
W        W
W RRRRRR W
WRRRCRRRRW
W RRRRRR W
W        W
W T      W
W        W
W        W
WWWW0WWWWW