#
# 0 D room1.txt 2
#
WWWW0WWWWW
WRR   RRRW
WR S   RRW
WWWWW   RW
WRR W  RRW
WR  W  WWW
W  H   RRW
WR    RRRW
WRR  RRRRW
WWWWWWWWWW
