#
# 0 D room2.txt 2 key2
#
WWWWWWWWWW
W        W
W  RRRR  W
W  R  R  W
W  RRRR  W
W        W
W        W
W        W
W        W
WWWW0WWWWW