#
# 0 D room7.txt 1
#
AAAAAAAAAA
W        W
W        W
W        W
0        W
W        W
W        W
W        W
W       fW
WWWWWWWWWW