#
# 0 D room4.txt 1
# 1 D room6.txt 0
#
WWWWWWWWWW
WRR RRR RW
WRRBRWRBRW
WRB  W   W
W S  W   W
WWWR W   W
W   SW   W
WR WWWRR W
WS RRWRRR1
WWWW0WWWWW