#
# 0 D room3.txt 1
# 1 D room5.txt 0
#
WWWW1WWWWW
WWWW WWWWW
WWWW WWWWW
WWWW WWWWW
WWWW WWWWW
WWWWCWWWWW
WWWW WWWWW
WWWW WWWWW
WWWW WWWWW
WWWW0WWWWW