#
# 0 E room11.txt 1
#
# k castleKey
#
WWWWWWWWWW
WGRWmmWWkW
WRRRRRRWRW
WR  R RWRW
0R  RRRWRW
WR R R WRW
WR RR RWRW
WG R GRWRW
WRR RRRRRW
WWWWWWWWWW