#
# 0 D room6.txt 1
# 1 D room8.txt 0
#
WWWWWWWWWW
Wt   t   W
Wt t   t W
Wt t ttt W
Wt   t   1
W  ttttttW
W t   t  W
W   t t  W
W tt  t  W
WWWW0WWWWW