#
# 0 D room2.txt 1
# 1 D room2.txt 0 key1
# 2 E room0.txt 0
#
# k key2
#
WWWW0WWWWW
Wt   t   W
W  t   t W
Wt  B    W
W  t   ttW
W   t tWWW
WR    RWkW
WRR  RRW W
WRRR RRW 1
WWWW2WWWWW
