#
# 0 E room8.txt 2
#
#
WWWWWWWWWW
W        W
W        W
WWWW     W
0        W
WWWW     W
W        W
W        W
W        W
WWWWWWWWWW