#
# 0 D room1.txt 1 key1
# 1 D room1.txt 0
# 2 D room3.txt 0 key2
#
# k key1
#
WWW2WWWWWW
WRS  G RRW
W       RW
W  m  k  W
WR       W
WR    RW W
W    BRWhW
W  RWWWW W
0R RW   RW
WWWWW1WWWW