#
# 0 D room2.txt 2 key2
# 1 D room4.txt 0
#
WWWW1WWWWW
WRRR RRRRW
WWRRRRRRWW
WRRR RRRRW
WWR RRR RW
WWR   RT W
WRRR R RRW
WW  R  RWW
WWRR RRWWW
WWWW0WWWWW