#
# 0 D room5.txt 1
# 1 D room7.txt 0
#
WWWW1WWWWW
WtttGttttW
Wtt    ttW
WtG    GtW
Wtt    ttW
WtG    GtW
Wt      tW
W       tW
0  ttttttW
WWWWWWWWWW